1111111111
1000000001
10100C0001
1000000001
100P000001
1111111111
