111111111111111
100010011001001
10100C000010001
100001000100001
10P00000C0000E1
111111111111111
