111111111111111
100010001100101
10100C000010001
100001000100C01
10P10000C0000E1
111111111111111
