111111111111111
100010001100101
10100C000010001
100E01000100C01
10P10000C000001
111111111111111
